1
1500
2
400
******************************
******************************
******************************
******************************
******************************
******************************
******************************
**********#####***************
**********#&&&####************
**********#&&&#&&#************
**********##&&&&.#************
*********###&###.#************
*********#&$&#*#.#************
*********#&$$#*###************
*********#@&&#****************
*********#####****************
******************************
******************************
******************************
******************************
